NO ./assets/textures/crate_1.xpm
SO ./assets/textures/crate_2.xpm
WE ./assets/textures/crate_3.xpm
EA ./assets/textures/crate_4.xpm

F 158,142,184
C 6,98,133



        1111111111111111111111111
        1000000000110000000000001
        1011000001110000000000001
        1001000000000000000000001
111111111011000001110000000000001
100000000011000001110111111111111
11110111111111011100000010011
11110111111111011101010010001
11000000110101011100000010001
10000000000000001100000000001
10000000000000001101010000001
11000001110101011111011100W0111
11110111 1110101 101111010001
11111111 1111111 111111111111
